38 38 38 38 38 38 38 38 38 38 38 38 38 38 38 38 38 38 38 38 38 38 38 38 38 38 38 38 38 38 38 38 38 38 38 38 38 38 38 38 38 38 38 38 38 38 38 38 38 38 38 38 38 38 38 38 38 38 38 38
38 38 38 38 38 38 38 38 38 38 38 38 38 38 38 38 38 38 38 38 38 38 38 38 38 38 38 38 38 38 38 38 38 38 38 38 38 38 38 38 38 38 38 38 38 38 38 38 38 38 38 38 38 38 38 38 38 38 38 38
38 38 38 38 38 38 38 38 38 38 38 38 38 38 38 38 38 38 38 38 38 38 38 38 38 38 38 38 38 38 38 38 38 38 38 38 38 38 38 38 38 38 38 38 38 38 38 38 38 38 38 38 38 38 38 38 38 38 38 38
38 38 38 38 38 38 38 38 38 38 38 38 38 38 38 38 38 38 38 38 38 38 38 38 38 38 38 38 38 38 38 38 38 38 38 38 38 38 38 38 38 38 38 38 38 38 38 38 38 38 38 38 38 38 38 38 38 38 38 38
38 38 38 38 38 38 38 38 38 38 38 38 38 38 38 38 38 38 38 38 38 38 38 38 38 38 38 38 38 38 38 38 38 38 38 38 38 38 38 38 38 38 38 38 38 38 38 38 38 38 38 38 38 38 38 38 38 38 38 38
38 38 38 38 38 38 38 38 38 38 38 38 38 38 38 38 38 38 38 38 38 38 38 38 38 38 38 38 38 38 38 38 38 38 38 38 38 38 38 38 38 38 38 38 38 38 38 38 38 38 38 38 38 38 38 38 38 38 38 38
38 38 38 38 38 38 38 38 38 38 30 30 30 30 70 0 0 71 30 30 30 30 30 30 30 30 30 70 11 71 30 30 70 1 3 1 1 0 0 0 0 0 0 0 0 0 0 0 0 0 38 38 38 38 38 38 38 38 38 38
38 38 38 38 38 38 38 38 38 38 72 72 31 30 70 0 0 26 72 72 72 72 72 72 72 32 30 70 0 73 74 74 75 0 0 0 0 0 0 0 0 0 0 7 0 0 0 0 0 0 38 38 38 38 38 38 38 38 38 38
38 38 38 38 38 38 38 38 38 38 0 0 71 30 70 0 0 0 0 0 0 0 9 0 0 73 74 75 0 71 30 30 70 0 0 10 0 0 0 0 0 0 0 0 0 0 0 0 0 0 38 38 38 38 38 38 38 38 38 38
38 38 38 38 38 38 38 38 38 38 0 0 71 30 70 0 0 0 7 0 0 0 0 0 0 71 30 33 76 29 30 30 70 0 0 0 0 0 0 7 0 0 0 0 0 0 0 0 12 0 38 38 38 38 38 38 38 38 38 38
38 38 38 38 38 38 38 38 38 38 0 0 73 74 75 0 0 0 0 0 0 0 0 0 0 71 30 30 77 30 30 30 70 0 0 7 0 0 0 0 0 0 0 0 0 0 0 0 0 0 38 38 38 38 38 38 38 38 38 38
38 38 38 38 38 38 38 38 38 38 0 0 71 30 70 0 0 0 0 0 0 7 0 11 0 71 30 30 77 30 30 30 70 0 0 0 0 0 0 0 0 0 7 0 0 0 0 0 0 0 38 38 38 38 38 38 38 38 38 38
38 38 38 38 38 38 38 38 38 38 0 0 71 30 70 0 0 0 0 0 0 0 0 0 0 71 30 30 77 30 30 30 70 0 0 0 0 0 0 0 0 0 0 0 0 0 0 0 0 0 38 38 38 38 38 38 38 38 38 38
38 38 38 38 38 38 38 38 38 38 0 14 71 30 70 0 0 0 0 0 0 0 0 0 7 26 72 72 78 31 30 30 70 0 0 0 0 0 7 0 0 0 0 0 0 0 7 0 0 0 38 38 38 38 38 38 38 38 38 38
38 38 38 38 38 38 38 38 38 38 0 0 71 30 70 0 0 0 0 7 0 0 7 0 0 0 0 0 0 71 30 30 70 0 0 0 7 0 0 0 0 0 0 0 0 0 0 0 0 0 38 38 38 38 38 38 38 38 38 38
38 38 38 38 38 38 38 38 38 38 0 0 71 30 70 0 0 0 0 0 0 0 0 0 0 0 7 0 12 71 30 30 70 0 0 0 0 0 0 0 0 7 0 0 0 0 0 0 0 0 38 38 38 38 38 38 38 38 38 38
38 38 38 38 38 38 38 38 38 38 0 0 71 30 70 0 0 0 0 0 0 0 0 7 0 0 0 0 0 71 30 30 70 0 0 0 0 0 0 0 0 0 0 0 0 0 0 0 0 0 38 38 38 38 38 38 38 38 38 38
38 38 38 38 38 38 38 38 38 38 0 0 73 74 75 0 0 0 7 0 0 0 0 0 0 0 0 0 0 73 74 74 75 0 0 0 0 0 0 0 0 0 0 0 0 0 7 0 0 0 38 38 38 38 38 38 38 38 38 38
38 38 38 38 38 38 38 38 38 38 7 7 71 30 70 12 0 0 0 0 0 7 0 0 0 7 0 0 14 71 30 30 70 0 0 0 0 0 0 0 0 0 0 0 0 0 0 0 0 0 38 38 38 38 38 38 38 38 38 38
38 38 38 38 38 38 38 38 38 38 0 0 71 30 70 0 0 0 0 15 0 0 0 0 0 0 0 0 0 71 30 30 70 0 0 0 0 0 0 0 0 0 0 0 0 0 0 0 0 0 38 38 38 38 38 38 38 38 38 38
38 38 38 38 38 38 38 38 38 38 0 0 71 30 70 0 0 0 0 0 0 0 7 0 0 0 0 0 0 71 30 30 70 0 0 0 7 0 0 0 0 0 0 0 0 0 0 0 0 0 38 38 38 38 38 38 38 38 38 38
38 38 38 38 38 38 38 38 38 38 0 0 71 30 70 0 0 0 0 0 0 0 0 0 0 0 0 0 0 71 30 30 70 0 0 0 0 0 0 0 7 0 0 0 0 0 0 0 0 0 38 38 38 38 38 38 38 38 38 38
38 38 38 38 38 38 38 38 38 38 0 0 71 30 70 0 7 0 0 0 0 0 0 0 0 0 7 0 0 71 30 30 70 0 0 0 0 0 0 0 0 0 0 0 0 0 7 0 0 0 38 38 38 38 38 38 38 38 38 38
38 38 38 38 38 38 38 38 38 38 0 0 71 30 70 0 0 0 0 0 0 0 0 0 0 0 0 0 0 71 30 30 70 0 0 7 0 0 0 0 0 0 0 0 0 0 0 0 0 0 38 38 38 38 38 38 38 38 38 38
38 38 38 38 38 38 38 38 38 38 0 0 71 30 70 0 0 0 0 0 7 0 0 0 0 0 0 0 0 71 30 30 70 0 0 0 0 0 0 0 0 0 7 0 0 0 0 0 0 0 38 38 38 38 38 38 38 38 38 38
38 38 38 38 38 38 38 38 38 38 0 0 71 30 70 0 7 0 0 0 0 0 0 0 0 0 0 0 0 71 30 30 70 0 0 0 0 0 0 0 0 0 0 0 0 0 7 0 0 0 38 38 38 38 38 38 38 38 38 38
38 38 38 38 38 38 38 38 38 38 0 0 71 30 70 0 0 0 0 0 0 0 0 0 0 0 0 0 0 73 74 74 75 0 0 0 0 0 0 0 0 0 0 0 0 0 0 0 0 0 38 38 38 38 38 38 38 38 38 38
38 38 38 38 38 38 38 38 38 38 0 0 71 30 70 0 0 0 0 0 0 0 0 7 0 0 0 0 0 71 30 30 70 0 0 0 7 0 0 0 0 5 3 2 5 1 2 3 0 0 38 38 38 38 38 38 38 38 38 38
38 38 38 38 38 38 38 38 38 38 0 0 71 30 70 0 7 0 0 0 0 0 0 0 0 0 0 0 0 71 30 30 70 0 0 0 0 0 0 0 0 5 0 0 0 0 0 5 0 0 38 38 38 38 38 38 38 38 38 38
38 38 38 38 38 38 38 38 38 38 0 0 71 30 70 0 0 0 0 0 0 0 0 0 7 0 0 0 0 71 30 30 70 0 0 0 0 0 0 0 0 4 0 3 3 4 0 3 0 0 38 38 38 38 38 38 38 38 38 38
38 38 38 38 38 38 38 38 38 38 0 0 71 30 70 0 0 0 0 0 0 0 0 0 0 0 0 0 0 71 30 30 70 0 0 0 0 0 0 0 0 2 0 2 0 1 0 0 0 0 38 38 38 38 38 38 38 38 38 38
38 38 38 38 38 38 38 38 38 38 0 0 71 30 70 0 0 0 0 0 7 0 0 0 0 0 0 0 0 71 30 30 70 0 0 7 0 0 0 0 0 3 0 1 0 3 2 4 5 2 38 38 38 38 38 38 38 38 38 38
38 38 38 38 38 38 38 38 38 38 0 0 73 74 75 0 0 0 0 0 0 0 0 0 0 0 0 0 0 71 30 30 70 0 0 0 0 0 0 0 0 5 0 5 0 0 0 0 0 0 38 38 38 38 38 38 38 38 38 38
38 38 38 38 38 38 38 38 38 38 0 0 71 30 70 0 0 0 0 0 0 0 0 0 0 7 0 0 0 71 30 30 70 0 7 0 0 0 0 0 0 3 0 3 0 4 3 2 0 0 38 38 38 38 38 38 38 38 38 38
38 38 38 38 38 38 38 38 38 38 0 0 71 30 70 0 12 0 0 0 0 0 0 0 0 0 0 0 0 71 30 30 70 0 0 0 0 0 0 0 0 1 0 0 0 2 15 0 0 0 38 38 38 38 38 38 38 38 38 38
38 38 38 38 38 38 38 38 38 38 38 38 38 38 38 38 38 38 38 38 38 38 38 38 38 38 38 38 38 38 38 38 38 38 38 38 38 38 38 38 38 38 38 38 38 38 38 38 38 38 38 38 38 38 38 38 38 38 38 38
38 38 38 38 38 38 38 38 38 38 38 38 38 38 38 38 38 38 38 38 38 38 38 38 38 38 38 38 38 38 38 38 38 38 38 38 38 38 38 38 38 38 38 38 38 38 38 38 38 38 38 38 38 38 38 38 38 38 38 38
38 38 38 38 38 38 38 38 38 38 38 38 38 38 38 38 38 38 38 38 38 38 38 38 38 38 38 38 38 38 38 38 38 38 38 38 38 38 38 38 38 38 38 38 38 38 38 38 38 38 38 38 38 38 38 38 38 38 38 38
38 38 38 38 38 38 38 38 38 38 38 38 38 38 38 38 38 38 38 38 38 38 38 38 38 38 38 38 38 38 38 38 38 38 38 38 38 38 38 38 38 38 38 38 38 38 38 38 38 38 38 38 38 38 38 38 38 38 38 38
38 38 38 38 38 38 38 38 38 38 38 38 38 38 38 38 38 38 38 38 38 38 38 38 38 38 38 38 38 38 38 38 38 38 38 38 38 38 38 38 38 38 38 38 38 38 38 38 38 38 38 38 38 38 38 38 38 38 38 38


